R 1080 1080

NO ./textures/Graphite.xpm
SO ./textures/Magnetite.xpm
WE ./textures/Babingtonite_1.xpm
EA ./textures/Schist.xpm

S textures/tonneau.xpm
F 51,52,78
C 87,77,51

111111111111111111111111111111111111111111111111111111111111111111111111111111111111111111111111
100000000000000000000000000000000000000000000000000000000000000100000000000000000000000000000001
100000000010000000000000000000000000002220000000000000000000000000000000000000000000000000000001
100000000000000000000000000000000000000000000000000000000000000100000000000000000000100000000001
100000000000000000011111000000000000000000000000000000000000000000000000000000000000000000000001
100000000000000000000000000000000000000000000000000000000000000000000000000000000000000000000001
100000000000000100000000000000000000000000000000000000000000000000000000000000000000000000000001
100000000000000111111111111111111111110000000000000000000000000000000000022200000000100000000001
100000000000000100000000000000001000000000000000000000000100000000000000000000000000000000000001
100000000000000100000000000000001000000000000000000000000100000000000000000000000000000000000001
100001000000000100000000000000001000000000000000000000000100000000000000000000000000000000000001
100000000000000100000000000000001000000000000000000000000100000000000000000000000000000000000001
100000000000000100000000000000001000000000000000000000000100000000000000000000000000000000000001
100000000000000100000000000000001000000000000000000000000100000000000000000000000000000000000001
100000000000000100000000000000001000000000000000000000000100000000000000000000000000000000000001
100000000000000100000000000000001000000000000000000000000100000000000000000000000000000000000001
100000000000000000000000000000000000001000000000000000000000000001000000000000000000000000000001
100000000000000000000000000000000000001000000000000000000100000001000000000000000000000000000001
100000000000000000002220000000000000001000000000100000000000000001000000000000000022200000000001
100000000000000000000000000000000000001000000000000000000000000001000000000000000000000000000001
100000000001111111111111111111111000000000000000000000000000100000000000000000000000000100000001
100000000000000000000000000000000000001000000000020000000000000001000000000000000000000000000001
100000000000000000000000000000000000001000000000000000000000000001000000000000000020000000000001
100000000000000000000000000000000000001000000000000000000000000001000000000000000000000000000001
100000000001000000000000000000000000000000000000000000000000000000000000000000000000000000000001
100000000000000000000000000000000000000000020000000E00000000000000000000000000000000000000000001
100000100000000000000000000200000002222222220000000000000000000000000000000000000000000000000001
100000000001000000000000000000000000000000020000000000000000000000200000000000000010000000000001
100000000000000000000000000000000000000000000000000000000000000000000000000000000000000000000001
100000000000000000000000000000000000000000000000000000000000000000000000000000000000000000000001
100000000001000000000000000001111111111111111111111111111100000000000200000000000000000000000001
100000000000000000000000000001000000000000000000000000000100000000000000000000000000000000000001
100000000200000000000000000001000000000000000000000000000100000000000000000000000020000000000001
100000000000000000000000000001000000000000200000000000000100000000000000000000000000000000000001
100000000000000000000000000001000000000000000000000000000100000000000000000010000000000000000001
100000000100000010000000000001000000000000000000000000000100000000000000100000000000000000000001
100000000000000000000000000001000000000000000000000000000100000000000000000000002220000000000001
100000000000000000000000000001111111111111111111111000000000000000000000000000002220000000000001
100000000200200000000000000000000000000000000000000000000000000000000000000000000000000000000001
111111111111111111111111111111111111111111111111111111111111111111111111111111111111111111111111