R 600 600

NO textures/wolfeagle.xpm
SO textures/stone.xpm
WE textures/Schist.xpm
EA textures/wallr.xpm

S textures/tonneau.xpm
F 220,100,0
C 225,30,100



111111111111111111111111
100000000000000000000001
100000000000000000000001
1000000000000000000000001
100000111110000101010000011
1000001000100000000000001
100000111010000100010001
100000100010000000000001
100000110110000000000001
100000000000000100000001
100000001111111000000001
100000000100001000000001
10000000000N001000000001
100000000102200100000001
100000000111011000000001
100000000000000000000001
111111111000000000000001
110100001000000000000001
110000001000000200000001
110100001000000000000011
110111111000000000000001
110000000000000000000001
111111111000000000000001
111111111111111111111111