R 200 200

NO textures/wolfeagle.xpm
SO textures/stone.xpm
WE textures/Schist.xpm
EA textures/wallr.xpm

S textures/tonneau.xpm 
F 220,100,0
C 225,30,234

11111111111111111
10000010010000011
1000100000100S001
11000100100000001
10000000200110111
11111111111111111